GGWWWWWGG
GBWBWBWBG
WWWWWWWWW
WBWBWBWBW
WWWWDWWWW
WBWBWBWBW
WWWWWWWWW
GBGBWBGBG
GGWWWWWGG