GGGWGWWGG
GBGBGBGBG
GGGGGGGGG
WBWBWBWBW
GWWGWGWWW
GBWBWBWBW
WWGWWWGGG
GBGBDBGBG
GGWWGWWGG