GGGGGGWGG
GGWGWGWGG
WWWWGWWGW
WBWBWBWBW
GWWGWGWWW
WBWBWBWBW
GWGGGWGWW
GBGBWBGBG
GGWWDWWGG