GGGGGGWGG
GGWGWGWGG
WWWWGWWGW
WBWBWBWBW
GWWGWGWWW
GBWBWBWBW
WWGGGWGWW
GBGBWBGBG
GGWWDWWGG